[
    {
        "x": 320,
        "y": 300
    },
    {
        "x": 320,
        "y": 450
    },
    {
        "x": 450,
        "y": 600
    },
    {
        "x": 550,
        "y": 750
    },
    {
        "x": 520,
        "y": 900
    },
    {
        "x": 380,
        "y": 1050
    },
    {
        "x": 250,
        "y": 1200
    },
    {
        "x": 150,
        "y": 1350
    },
    {
        "x": 250,
        "y": 1500
    },
    {
        "x": 320,
        "y": 1650
    },
    {
        "x": 400,
        "y": 1800
    },
    {
        "x": 480,
        "y": 1950
    },
    {
        "x": 320,
        "y": 2100
    },
    {
        "x": 200,
        "y": 2250
    },
    {
        "x": 100,
        "y": 2400
    }
]