[
    {
        "x": 320,
        "y": 300
    },
    {
        "x": 320,
        "y": 450
    },
    {
        "x": 410,
        "y": 600
    },
    {
        "x": 500,
        "y": 750
    },
    {
        "x": 590,
        "y": 900
    },
    {
        "x": 500,
        "y": 1050
    },
    {
        "x": 410,
        "y": 1200
    },
    {
        "x": 320,
        "y": 1350
    },
    {
        "x": 230,
        "y": 1500
    },
    {
        "x": 320,
        "y": 1650
    },
    {
        "x": 410,
        "y": 1800
    },
    {
        "x": 500,
        "y": 1950
    },
    {
        "x": 410,
        "y": 2100
    },
    {
        "x": 320,
        "y": 2250
    },
    {
        "x": 230,
        "y": 2400
    },
    {
        "x": 320,
        "y": 2550
    },
    {
        "x": 320,
        "y": 2700
    }
]