[
    {
        "x": 320,
        "y": 300
    },
    {
        "x": 320,
        "y": 400
    },
    {
        "x": 320,
        "y": 500
    },
    {
        "x": 320,
        "y": 600
    },
    {
        "x": 320,
        "y": 700
    },
    {
        "x": 320,
        "y": 800
    },
    {
        "x": 320,
        "y": 900
    },
    {
        "x": 320,
        "y": 1000
    },
    {
        "x": 320,
        "y": 1100
    },
    {
        "x": 320,
        "y": 1200
    },
    {
        "x": 320,
        "y": 1300
    },
    {
        "x": 320,
        "y": 1400
    },
    {
        "x": 320,
        "y": 1500
    },
    {
        "x": 320,
        "y": 1600
    },
    {
        "x": 320,
        "y": 1700
    },
    {
        "x": 320,
        "y": 1800
    },
    {
        "x": 320,
        "y": 1900
    },
    {
        "x": 320,
        "y": 2000
    },
    {
        "x": 320,
        "y": 2100
    },
    {
        "x": 320,
        "y": 2200
    },
    {
        "x": 320,
        "y": 2300
    },
    {
        "x": 320,
        "y": 2400
    },
    {
        "x": 320,
        "y": 2500
    },
    {
        "x": 320,
        "y": 2600
    },
    {
        "x": 320,
        "y": 2700
    }
]